17 9 7
W W W W W W W W W
W W W W W W W W
W W P 1 M 1 W D 2 P 2 M 2 W
W P 1 C 1 T M 1 R P 2 C 2 T W
W M 3 P 3 W D 1 M 1 W P 2 W
P 3 C 3 T M 3 W W M 2 P 2 W
W M 3 W R R W P 4 M 4 W
W P 3 W C 4 T P 4 W W W
W M 5 P 5 R W R P 4 M 4 W
P 5 C 5 T D 5 W W P 7 M 7 W
W M 5 W W R W P 7 C 7 T W
W D 6 M 6 R P 7 M 7 W W
W P 6 C 6 T M 6 W D 7 P 7 W W
W M 6 P 6 W W W W W
W W P 6 M 6 W W W W W
W W W W W W W W
W W W W W W W W W 