17 10 7
W W W W W W W W W W
W W W W W W W W W
W W P 1 M 1 W W D 2 P 2 M 2 W W
W W W M 1 W W W C 2 F W
W P 3 W W W D 1 M 2 W P 1 W W
W P 3 M 3 W W W W M 2 W
W M 3 W W W W W D 4 M 4 W W
W D 3 W W W C 4 F P 4 W W
W P 3 W W W P 4 P 4 W W W W
W C 3 F W W W W W P 7 P 7 W
W M 3 W W W D 6 M 6 W P 7 W
W P 5 M 5 W W W M 6 P 7 W
W P 5 M 5 W D 5 W P 7 C 7 F W
W P 5 C 5 F P 5 W D 6 C 6 F W
W M 5 P 5 D 5 W M 6 P 6 P 6 W
W W W W W W W W W
W W W W W W W W W W